111111111111111111111111111111111111111400001111111111221111111111001111111111001111111111031111111111011111111111011111111111311111111111111111
111111111111111111111111111111111111111111001111114200001111111111101111111111101111111001100111111000000111111011111111111311111111111111111111
111110011111111114000001111100011001033101011011000002001211100101000011111100011211111111111001111130000001111111111111111111111111111111111111
111111111111111111111111111111111111110011111111100000011111103312011111111002011111111114011111111111111111111111111111111111111111111111111111
111111111111111111111111111111111111111100311111111021311111111000011111111101001111111120401111111100011111111111111111111111111111111111111111
111111111111111111111111111111111111111111031111111111001111111102200111111100000111111112101111111113431111111111111111111111111111111111111111
111111111111111111111111111111111111111333341111110020120111110020020111110011000111111111111111111111111111111111111111111111111111111111111111
111111111111111114001111111302031111111002011111111101111111110200111111100000111111130011111111111111111111111111111111111111111111111111111111
111111111111111111111111111111001111110003321111110241020111111233000111111001100111111111111111111111111111111111111111111111111111111111111111